NO ./asset/1.xpm
SO ./asset/6.xpm
WE ./asset/7.xpm
EA ./asset/8.xpm

F 220,100,0
C 225,30,0

111111111111111111111111111111111111111111111111111111111111111111        
100000000011000000000000000000000000000000000000000000000000000001        
111111111111000000000000000000000000000000000000000000000000000001        
1001000000000000000000000000000000000000000000000000000000000000111111111
11111111101100000000000000000000000000000000000000000000001110000001000001
10000000001100000000000000000000000000000000000000000000001110111111111111
1111011111111100000000000000000000N00000000000000000000011100000010001    
1111011111111100000000000000000000000000000000000000000011101010010001    
1100000011010100000000000000000000000000000000000000000011100000010001    
1000000000000000000000000000000000000000000000000000000001100000010001    
1000000000000000000000000000000000000000000000000000000001100000010001    
1000000000000000000000000000000000000000000000000000000001100000010001    
1000000000000000000000000000000000000000000000000000000001100000010001    11
1000000000000000000000000000000000000000000000000000000001100000010001    
1000000000000000000000000000000000000000000000000000000001100000010001    1 
1000000000000000000000000000000000000000000000000000000001100000010001    
1000000000000000000000000000000000000000000000000000000001100000010001    
1000000000000000000000000000000000000000000000000000000001100000010001    
1000000000000000000000000000000000000000000000000000000001100000010001    
1000000000000000000000000000000000000000000000000000000001101010010001    
110000011101000000000000000000000000000000000000000000101111101111000111  
11110111 111000000000000000000000000000000000000000000101 101111010001    
11111111 111111111111111111111111111111111111111111111111 111111111111    