NO ./path_to_the_north_texture
SO ./path_to_the_south_texture
WE ./path_to_the_west_texture
EA ./path_to_the_east_texture

F 220,100,0
C 225,30,0

111111111111110000000000000000000000000000000000000000011111111111        
100000000011000000000000000000000000000000000000000000000000000001        
10110N000111000000000000000000000000000000000000000000000000000001        
10010000000000000000000000000000000000000000000000000000000000000111111111
11111111101100000000000000000000000000000000000000000000001110000001000001
10000000001100000000000000000000000000000000000000000000001110111111111111
1111011111111100000000000000000000000000000000000000000011100000010001    
1111011111111100000000000000000000000000000000000000000011101010010001    
1100000011010100000000000000000000000000000000000000000011100000010001    
1000000000000000000000000000000000000000000000000000000001100000010001    
1000000000000000000000000000000000000000000000000000000001100000010001    
1000000000000000000000000000000000000000000000000000000001100000010001    
1000000000000000000000000000000000000000000000000000000001100000010001    
1000000000000000000000000000000000000000000000000000000001100000010001    
1000000000000000000000000000000000000000000000000000000001100000010001    
1000000000000000000000000000000000000000000000000000000001100000010001    
1000000000000000000000000000000000000000000000000000000001100000010001    
1000000000000000000000000000000000000000000000000000000001100000010001    
1000000000000000000000000000000000000000000000000000000001100000010001    
1000000000000000000000000000000000000000000000000000000001101010010001    
110000011101000000000000000000000000000000000000000000101111101111000111  
11110111 111000000000000000000000000000000000000000000101 101111010001    
11111111 111111111111111111111111111111111111111111111111 111111111111    