NO ./path_to_the_north_texture
SO ./path_to_the_south_texture
WE ./path_to_the_west_texture
EA ./path_to_the_east_texture

F 220,100,0
C 225,30,0

111111111111111111111111122222222
100000000011000000000000122222222
101100000111000000000000122222222
100100000000000000000000122222222
111111111011000001110000000000001
100000000011000001110111111111111
111101111111110111000000100012222
111101111111110111010100100012222
110000001101010111000000100012222
100000000000000011000000100012222
100000000000000011010100100012222
11000001110101011111011110N011122
111101112111010121011110100012222
111111112111111121111111111112222