NO /Users/seulee2/Desktop/cub/cub3d/asset/5.xpm
SO /Users/seulee2/Desktop/cub/cub3d/asset/6.xpm
WE /Users/seulee2/Desktop/cub/cub3d/asset/7.xpm
EA /Users/seulee2/Desktop/cub/cub3d/asset/8.xpm

F 220,100,0
C 225,30,0

111111111111111111111111111111111111111111111111111111111                     
100000000011000000000111000000000000000000000000000000001        
101100000111000000000111000000000000000000000000000000001        
1001000000000000000001110000000000000000000000000000000011111111111111
1011111101100000000011100000000000000000000000001110000000000000000001
1000000000110000000001110000000000000000000000000111011111111111111111
1011011111111100000001110000000000000000000000011100000010001    
1011011111111100000001110000000000000000000000011101010010001    
1000000011010100000001110000000000000000000000011100000010001    
1000000000000000000001110000000000000000000000001100000010001    
1000000000000000000001110000000000000000000000001100000010001    
1000000000000000000001110000000000000000000000001100000010001    
1000000000000000000001110000000000000000000000001100000010001    
1000000000000000000001110000000000000000000000001100000010001    
1000000000000000000001110000000000000000000000001100000010001    
1000000000000000000001110000000000000000000000001100000010001    
1000000000000000000001110000000000000000000000001100000010001    
1000000000000000000001110000000000000000000000001100000010001    
1000000000000000000001110000000000000000000000001100000010001    
1000000000000000000001110000000000000000000000001101010010001    
1100000111010000000000000010111110111100011111111111111111111
11110111 11100000000000000101 101111010001    
11111111 111111111111111111111111111111111