NO ./asset/1.xpm
SO ./asset/6.xpm
WE ./asset/7.xpm
EA ./asset/8.xpm

F 22,0,0
C 5,14,5

 1111111111111111111111111111111111111111111111111111111                                         
100000000011000000000111000000000000000000000000000000001        
101100000111000000000111000000000000000000000000000000001        
1001000000000000000001110000000000000000000000000000000011111111111111
1011111101100000000011100000000000000000000000001110000000000000000001
1000000000110000000001110000000000000000000000000111011111111111111111
1011011111111100000001110000000000000000000000011100000010001    
1011011111111100000001110000000000000000000000011101010010001    
1000000011010100000001110000000000000000000000011100000010001    
1000000000000000000001110000000000000000000000001100000010001    
1000000000000000000001110000000000000000000000001100000010001    
100000000E000000000001110000000000000000000000001100000010001    
1000000000000000000001110000000000000000000000001100000010001    
1000000000000000000001110000000000000000000000001100000010001    
1000000000000000000001110000000000000000000000001100000010001    1
1000000000000000000001110000000000000000000000001100000010001    
100000000000000000000111000000000111111111111111111111111111     111
1000000000000000000001110000000000000000000000001100000010001     101
1000000000000000000001110000000000000000000000001100000010001      1
1000000000000000000001110000000000000000000000001101010010001                      
1100000111010000000000000010111110111100011111111111111111111
11110111 11100000000000000101 101111010001    
 1111111 11111111111111111111111111111111
                                       