NO /Users/seulee2/Desktop/cub/cub3d/asset/wall1.xpm
SO /Users/seulee2/Desktop/cub/cub3d/asset/wall1.xpm
WE /Users/seulee2/Desktop/cub/cub3d/asset/wall1.xpm
EA /Users/seulee2/Desktop/cub/cub3d/asset/wall1.xpm

F 220,100,0
C 225,30,0

111111111111111111111111111111111111111111111111111111111111111111        
100000000000000000000000000000000000000000000000000000000000000001
100000000000000000000000000000000000000000000000000000000000000001
100000000000000000000000000000000000000000000000000000000000000001
100000000000000000000000000000000000000000000000000000000000000001
100000000000000000000000000000000000000000000000000000000000000001
100000000000000000000000000000000000000000000000000000000000000001
100000000000000000000000000000000000000000000000000000000000000001
100000000000000000000000000000000000000000000000000000000000000001
100000000000000000000000000000000000000000000000000000000000000001
100000000000000000000000000000000000000000000000000000000000000001
111111111111111111111111111111111111111111111111111111111111111111    