NO /Users/seulee2/Desktop/cub/cub3d/asset/wall1.xpm
SO /Users/seulee2/Desktop/cub/cub3d/asset/6.xpm
WE /Users/seulee2/Desktop/cub/cub3d/asset/4.xpm
EA /Users/seulee2/Desktop/cub/cub3d/asset/6.xpm

F 255,100,0
C 0,30,0

 1
1N1
 1

1111
1  1
1111
